eGregorio_Torres	rhasWonPrize	eFrickley_Athletic_F.C.
eGiovanni_Pasquale	risAffiliatedTo	eCarolina_RailHawks
ePeter_Masterson	rplaysFor	eBologna_F.C._1909
eJimmy_Ashcroft	risLocatedIn	eScotland_national_football_team
eRouyn-Noranda	risAffiliatedTo	ePhilosophy_of_language
eHarri_Ylönen	risAffiliatedTo	eF.C._Dynamo_Kyiv
eBruno_Uvini	rwasBornIn	eInglewood_United_SC
eAdelaide_of_Susa	rplaysFor	ePanathinaikos_F.C.
eBradley_Thomas_(footballer)	risLocatedIn	eHamburger_SV_II
eWhippany,_New_Jersey	risAffiliatedTo	eColombia
eAlo_Bärengrub	rplaysFor	eUniversity_of_Padua
eFrank_McKenna_(footballer)	ractedIn	eLower_Saxony
eCesária_Évora_Airport	rplaysFor	emale
eMike_Pence	ractedIn	eJagiellonia_Białystok
ePatrick_Parizon	rhasGender	eEngland_national_under-21_football_team
eRadosav_Petrović	risLocatedIn	eJoe_Clark
eLeo_Lainer	rplaysFor	eStandard_Liège
eYasin_Karaca	rplaysFor	ePogoń_Szczecin
eRadostin_Kishishev	risLocatedIn	eMichigan
eChampaign_County,_Illinois	rplaysFor	eH.N.K._Hajduk_Split
eLogan_Tom	rplaysFor	eGlenfield_Rovers
eSaša_Radivojević	rhasGender	eFC_Etar_1924_Veliko_Tarnovo
eRezső_Somlai	risAffiliatedTo	ePFC_Slavia_Sofia
eMarc_Smyth	rhasGender	eJohn_of_Gaunt,_1st_Duke_of_Lancaster
eLuigi_Simoni	risAffiliatedTo	eBFC_Siófok
eJohn_Waters	rwasBornIn	eMeet_the_Deedles
ePaul_Montel	risLocatedIn	eAssociação_Desportiva_São_Caetano
eAlghero	rplaysFor	eHellerup_IK
eMoise_Kandé	risAffiliatedTo	eGlenfield_Rovers
eRudi_Gores	risAffiliatedTo	eFC_Sportist_Svoge
eRéda_Johnson	risAffiliatedTo	emale
eNicolas_Raynier	risAffiliatedTo	eFC_Spartak_Moscow
eCurtis_Allen	ractedIn	eSeongnam_FC
eLeung_Chi_Wing	risAffiliatedTo	eSpun
eJ._M._G._Le_Clézio	rhasGender	eGalatasaray_S.K._(football)
eLeonīds_Ostrovskis	risAffiliatedTo	eBattle_of_Toulon_(1707)
eRoy_Ellam	rplaysFor	eLiga_Muçulmana_de_Maputo
eKamil_Agalarov	rplaysFor	eChainat_Hornbill_F.C.
eWilfred_Owen	rplaysFor	eOxford_United_F.C.
eRisaralda_Department	rhasGender	eSociedade_Esportiva_e_Recreativa_Caxias_do_Sul
eCatania–Fontanarossa_Airport	risAffiliatedTo	eDundee_United_F.C.
eSean_Canham	rplaysFor	ePort_Talbot
ePompoï_Department	ractedIn	eC.A._River_Plate
eTaras_Kabanov	rplaysFor	eBerlin
ePeter_Cushing	risLocatedIn	eDerby_County_F.C.
eIván_Gabrich	rhasWonPrize	eAsante_Kotoko_SC
eThe_Contract_(2006_film)	risAffiliatedTo	eNew_York_City
eRomain_Reynaud	rplaysFor	eArnold_Town_F.C.
eJean-Louis_Akpa_Akpro	rplaysFor	eOlympique_Alès
eImizu,_Toyama	rhasGender	eKosovo_War
eTuscaloosa,_Alabama	risAffiliatedTo	eTemple_University
eValerio_Di_Cesare	risAffiliatedTo	eNorth_Korea_national_football_team
eBehshad_Yavarzadeh	risAffiliatedTo	eRobert_Peters
eTed_Post	rplaysFor	eWysokie_Mazowieckie
eRafael_Savério_Gatti	ractedIn	eThe_Edge_(1997_film)
eSally_(1929_film)	rwasBornIn	eNew_York_metropolitan_area
eJames_Blackwell	risConnectedTo	eS.L._Benfica
eVladimir_But	rplaysFor	eVfB_Stuttgart
eMichael_Carr_(footballer)	risAffiliatedTo	eRhyl_F.C.
ePavelas_Leusas	risLocatedIn	eNK_Radomlje
ePetros_Filaniotis	rhasGender	eNorway_national_under-21_football_team
eCiarán_Hinds	rhasChild	eBad_Boys_(1995_film)
eTim_Danneberg	risLocatedIn	eFC_Kryvbas_Kryvyi_Rih
eJoeri_Dequevy	rplaysFor	eG.C._Alcobaça
eThomas_Kleine	rhasGender	eLuton_Town_F.C.
eMick_Harford	rcreated	eÉcole_pratique_des_hautes_études
eAndrei_Neagoe	risAffiliatedTo	eMonarcas_Morelia
ePrakash_Raj	rplaysFor	emale
eVelislav_Vutsov	risAffiliatedTo	eDaejeon_Citizen_FC
eMauricio_Donoso	risAffiliatedTo	ePerth_Glory_FC
eFulton,_Oswego_County,_New_York	risAffiliatedTo	eLe_Havre_A.C.
eDarren_Baxter_(English_footballer)	risAffiliatedTo	eAlki_Larnaca_F.C.
eJiří_Jeslínek_(footballer_born_1987)	rplaysFor	eManchester_City_F.C.
eAndy_Fensome	risLocatedIn	emale
eDerek_Doyle	rgraduatedFrom	eSeattle_SuperSonics
eDjamel_Menad	rplaysFor	eChile
eDario_Smoje	risAffiliatedTo	eAmérica_Futebol_Clube_(RN)
eKily_González	risAffiliatedTo	eAngora_Love
eMarko_Arnautović	rplaysFor	eTyrrhenian_Sea
ePerry_Kitchen	risAffiliatedTo	eSaint-Quentin,_Aisne
eDiktmar_Hernández	risConnectedTo	eAl-Arabi_SC_(Qatar)
eDavid_Vržogić	rplaysFor	eAssociação_Naval_1º_de_Maio
eMahi_Khennane	risLocatedIn	eA.C._ChievoVerona
eRainer_Hauck	rplaysFor	eAll_the_King's_Men_(2006_film)
eJunior_Bent	rplaysFor	eWycombe_Wanderers_F.C.
ePetros_Filaniotis	risLocatedIn	eFC_Sioni_Bolnisi
eJürgen_Macho	risLocatedIn	eChelmsford_City_F.C.
eTote_(footballer)	risAffiliatedTo	eSouth_Korea_national_football_team
eDavid_Neave	risAffiliatedTo	eCzech_Republic_national_football_team
eKrzysztof_Nowak	risAffiliatedTo	eCincinnati/Northern_Kentucky_International_Airport
eHaris_Medunjanin	rhasGender	eFC_Metz
ePatrick_Thoresen	rplaysFor	eArsenal_F.C.
eChristian_McClean	ractedIn	eMorecambe_F.C.
eLouie_Donowa	rplaysFor	eTorp
eÂnderson_Miguel_da_Silva	rwasBornIn	ewordnet_guitar_103467517
eWang_Xiao	ractedIn	eChengdu_Tiancheng_F.C.
eŠempeter_pri_Gorici	rhasMusicalRole	eBSFA_Award
eAli_Tandoğan	rinfluences	eAngora_Love
eGuga_(footballer_born_1964)	risAffiliatedTo	eKnattspyrnufélag_Reykjavíkur
eCarl_Jones	rplaysFor	eGKS_Katowice
